111111111111111
100000000000001
100000000000001
100000000000001
1C00P00P00000E1
111111111111111
