111111111111111
100000000000001
100000000000001
100000000000001
1C0000E0W0000P1
111111111111111
