11111111111111111111111111111111111111111111111111111111
100000000000000000000000000000000000000000000000000001C1
10000000000000000000000000000000000000000000000000000001
1P000000000000000000000000000000000000000000010101C10101
11111111111110000111111111111111111111000000111111111111
10000000000000000000010000000000000000000000000000000001
11000010000000001000010000000000000000000010000000001101
1C0001110000000010000100000000000000000001000000000111C1
11111111111111111111111111111111111111000111111111111111
1C000000000000000000000000000000000000000000000000000011
11000000000000000000000000000000000000000000010010100001
110000000000000000000000000000000000001010101010000001C1
10011111111111111111111111111111111111111111111111111111
100000000000000000000000000000000000000000001000000000C1
10000000000000000000000000000000000010000001010000000001
10000000000000000000000000000000000111000011111000000001
10000000000000000000000000000000001101100000000000000011
11111111111111111111111111111111100111111111111111111111
11111111111111111111100001111111100111111111111111111111
11111111111111111100000000000000000000000000000000000011
11111111111111111001110011111111111111110111111111110111
11111111100000000011110011111111111111110111111111110111
11111111100011110011110011111111111111110111111111110111
10000000001000000100000011100000000000000111111111110111
1111111111111110000000001000111111111111E000000000000011
11111111111111111111111111111111111111111111111111111111
