11111111111111111111111111111111111111111111
11111111111111111111111111111111111111111111
11111111111111111111111111111111111111111111
11111111111111111111111111111111111111111111
11111111111111111111111111111111111111111111
100000000000000000000000000000C0000000000001
1000000000G000000000000000000010000000E00001
10000000000000000000000000000111000000100001
1000000000000000000001C000000010000111111111
10000000000000C00000111000000000001100010011
10000000000000111100010000010000011111111111
1000001110000000000000000001000011C100010011
1P000011100000C00000000000010000000111111111
11111111111111111111111111111111111111111111
