11111111111111111111111111111
10000000000000000000000000001
10000000000000000000000000001
10000000000000000000000000001
1000000000000P0000000000000E1
11111111111111111111111111111