111111111111111111111111111111111111
100000000000000000000000000000000001
100000000000000000000000000000000001
111001111111111111111111111111111101
111001111111111111111111111111111001
100000000000000000000000000000000001
110000000000000000000000000000000001
111111111111111111111111111111111111
