111111111111111111111111111111111111
100000000000000000000000000000000001
10000000000000000000000000000C000001
100000000000000000000000000001000001
111111100100000000000000000011000001
11111110C1000000000000000000100C0001
111111111111111111111111111111111111
