111111111111111
100000000000001
100000000000001
100000000000001
100000000000001
1P0000000000CE1
111111111111111
