11111111111111111111
10000000000000000011
10000000000000000011
10000000000000000001
10000000011000000001
10000010010000000001
10000000000000000001
10000000000000000001
11111111111111111111