111111111111111
1000000000001C1
110000000000111
101000000000001
100100000000001
100001000001001
100010000001001
1P0100000001CE1
111111111111111
