11111111111111111111111111111
10000000000000000000000000001
1P000000000C0000000000C000001
10000000000000000000000100001
10000000C000000000100011000D1
10000000C000000001000011000D1
10000000C000000010000011000D1
10000010C000000100000011000D1
10000010C000000000000011000D1
11111111111111111111111111111