1111111111111111111111111111111111111
1000000000000000000000000000000000001
1000000C000C0000000000000000000000001
100000010C010000000000000000000000001
100000001110000000D000000000000000001
1100000011000010001000000000000000001
1110000001000010011000000000000000001
11110000C0000C10111000000000000000001
1111111111111111111111111111000000001
1111111111111111111111111111000000001
1111111111111111111111111111000000001
1111111111111111111111111111000000001
1111111111111111111111111111111111111