111111111111111
100000000000001
100000000000001
100000000000001
100000000000001
100000000000001
100000000000001
1P000000000GCE1
111111111111111
