11111111111111111111111111111
10000000000000000000000000001
10000000000000000000000000001
10000000000000000000000000001
10000000000000000000000000001
10000000000000000000000000001
10000000000000000000000000001
10000000000000000000000000001
10000P000000000E0000000000001
1000010000000000000000000C001
10000100000000000000000100001
10000100C00000C0000000010D001
11111111111111111111111111111