11111111111111111111111111111
10000000000000000000000000001
1000000C000C00000000000000001
100000010C0100000000000000001
100000001110000000D0000000001
11000000110000100010000000001
11100000010000100110000000001
11110000C0000C101110000000001
11111111111111111111111111111