11111111111111111111111111111
100000000000000E0000000000001
10000000000000C00000000000001
10000000000011110000000D000C1
10000C00000001000000011110001
1P000C000000C1000000010010001
11111111111111111111111111111