1111111111
1000100001
1110000111
1000100001
1111111111