111111111111111
100000000000001
110000000000001
101000000000001
100100000000001
100001000001001
100010000001001
1P0100000001CE1
111111111111111
