11111111111111111111
10000000000000000001
1000000C000C00000001
100000010C0100000001
100000001110000000D1
11000000110000100011
11100000010000100111
1111000000000C101111
11111111111111111111