11111111111111111111111111111
100000000000000000000000000E1
1P000000000C0000000000C000001
10000000000000000000001000001
10000000C000000000000011000D1
11111111111111111111111111111