11111111111111111111111111111
10000000000000000000000000001
10000000000000C00000000000001
10000000000011110000000D00001
10000000000000000000011110001
1PE0000000000C000000010010001
11111111111111111111111111111