111111111111111
10000001C100111
110000010111111
101000000000001
100100000000001
100000001001001
100000000001001
1P0100000001CE1
111111111111111
