11111111111111111111111111111
100000000000000000000000000C1
10000000000000000000000000001
10000000000000000000000000001
10000000000000000010000000001
10000000000000000010100100101
10000000010100000010100000101
1P000C0001C1000000101000001D1
11111111111111111111111111111