111111111111111
100000000000111
110000000000111
101000000000001
100100000000001
100000000001001
100000000001001
1P010G000001CE1
111111111111111
