11111111111111111111111111111
10000000000000000000000000001
10000000000000C00000000000001
1P000000000011110000000D00001
10000000000000000000011110001
1000000000000C000000010010001
11111111111111111111111111111