11111111111111111111
10000000000000000001
10000000000C00000001
10000001000100000001
100000001110000000D1
11000000010000000011
11100000010000000111
1111000000000C001111
11111111111111111111