1111111111111
1000000100001
1000001110001
1000000100001
1111111111111