11111111111
1P0000CE1
111111111
