1111111111111111111111111111111111111111111111111111111111111111111111111111111111111111111111111111111111111111111111111111111111111111111
1000000000000000000000000000000000000000000000000000000000000000000000000100010000000000000000000000000000000000000000000000000000000000001
1000000000000000000000000000000000000000000000000000000000000000000000000000010000000000000000C00000000000000000000000000000000000001000001
100000000000000000000000000000000000000000000000000000000000000000000000000C010000000000000000100001100010000000000000000000000000011100001
1000000000000000000000000000000000000000000000000000000000000000000000000011110000000000000001110000000111000000000000000000000000001000001
1000000000000000000000000000000000000000000000000000000000000000000000010000000000000000000000100000000010000000000000000000000000000000001
1000000000000000000000000000000000000000000000000000000000000000000001000000000000000000000000000000000000000000100000000000000001000000001
1000000000000000000000000000000000000000000000000000000000000000000000000000000000000000000000000000000000001001110000000000000011100000001
1000000000000000000000000000000000000000000000000000000011101110011100000000000000000000000000000000000001000000100000000000000001000000001
1000000000000000000000000000000000000000000000000010000000000000000000000000000000000000000000000000000001000000000000000000000000E00000001
1000000000000000000000000000000000000000000000000011100000000000000000000000000000000000000000000000000000000000000000000000000000100000001
1000000000000000000000000000000000000000000000000000010000000000000000000000000000000000000000000000000000001000000000000000000000100000001
1000000000000000000000000000000000000000000000000000010000000000000000000000000000000000000000000000000000010000000000000000000000100000001
1000000000000000000000000000000000000000000000000000011100000000000000000000000000000000000000000000000000100000000000000000011111111111001
100000000000000000000C000000000000000100000000000000000010000000000000000000000000000000000000000000000001000000000000000000010000000001001
1000000000000000001111110000000000001110000000000000000001000000000000000000000000000000000000000000000010000000000000000001011111111111001
1000000000000100000000000000000000011111000000000000000000001000000000000000000000000000000000000000000100000000000000000010010000000001001
10001110000011000000000000000000001111111C0000000000000000010000000000000000000000000000000000000000001000000000000000000100011111111111001
1P001110000111C0000000000000C00001111111110000000000000000100000000000000000000000000000000000000000010000000000000000001000010000000001001
1111111111111111111111111111111111111111111111111111111111111111111111111111111111111111111111111111111111111111111111111111111111111111111
