111111111111111111111111111111111111111111111
100001111110000000000000000001111110000000001
100001111110000000000000000001111110000000001
100001111110000000000000000001111110000000001
100001111110000000000000000001111110000000001
100001111110000000001111110001111110000000001
1000011111100000000000000000C1111110000000001
100001111110000000000000000011111110000000001
1000011111100000010C1000000001111110000000001
1000011111100000010C1000000001111110000000001
1000011111100000010C1000000001111110000000001
1000011111100000100C0100000001111110000000001
100001111110001100000011000001111110000000001
100001111110100001001000010001111110000000001
100001111110000010000010000001111110000000001
1000011111100001000C0100000001111110000000001
1000011111100010000C0000100001111110000000001
100001111110000010000100100001111110000000001
1000011111100100001C1000010001111110000000001
100001111110000001000100000001111110000000001
100001111110000010000010000001111110000000001
100001111110000100000001000001111110000000001
1000011111100000000C0000000001111110000000001
100001111110100000000000001001111110000000001
1000011111100111000C0001110001111110000000001
1000011111100000000E0000000001111110000000001
100001111110000000111000000001111110000000001
100001111110000110000011000001111110000000001
100001111110010000000000001001111110000000001
100001111110001000000000010001111110000000001
100001111110000100000000100001111110000000001
10000111111000001000P001000001111110000000001
111111111111111111111111111111111111111111111
