111111111111111111111111111111111111111111111
100000000000000000000011100000000000000000001
100000000000000000000110110000000000000000001
100000000000000000001100011000000000000000001
100000000000000000011000001100000000000000001
1000000000000000001111C0000110000000000000001
100000000000000001111100000011000000000000001
100000000000000011000000001001100000000000001
10000000000000C110000000011000110000000000001
100000000000001100000000111000011000000000001
100000000000011000000001111000001100000000001
100000000000000001111111111110000110000000001
100000000001111110000000000000000011000000001
100000000011C10000000000000000010011111111111
110000000110010000000000000000010000111001011
1P000000110000010000000C00000010011000000E111
111111111111111111111111111111111111111111111
