111111
100011
100101
100101
1PE1C1
111111
