111111
100101
100101
100101
1PC1E1
111111
