111111
1000E1
1C0011
110001
1000C1
100011
1C0001
110001
1000C1
100011
1C0001
110001
1000C1
100011
1C0001
1100C1
100011
10P001
111111