11111111111111111111
10000000000000000001
10000000000000000001
10000000000000000001
11000000000000000001
1P10000E0000000000C1
11111111111111111111
