11111111111111111111
10000000000000000001
10000000000000000001
10000000000000000001
11000000000000000011
100C000E0000000001P1
11111111111111111111
