11111111111111111111
100000000000000001C1
10000000000000000011
10000000000000000001
11000000000000000011
100E000P000000000001
11111111111111111111
