11111111111111111111
10000000000000000001
10000000000000000001
10000000000000000001
11000000000000000001
1C10000P0000000000E1
11111111111111111111
