11111111111111111111
1C100000000000000001
11000000000000000001
10000000000000000001
10000000000000000001
1000000P0000000000E1
11111111111111111111
