11111111111111111111
10000000000000000001
10000000000000000001
10000000000000000001
11000000000000000011
100E000P0000000001C1
11111111111111111111
