11111111111111111111111111111111111111111111111111111111111111111111111111111111111111111111111111111111111111111111111111111111111
11111111111111111111111111111111111111111111111111111111111111111111111111111111111111111111111111111111111111111111111111111111111
11111111111111111111111111111111111111111111111111111111111111111111111111111111111111111111111111111111111111111111111111111111111
11111111111111111111111111111111111111111111111111111111111111111111111111111111111111111111111111111111111111111111111111111111111
11111111111111111111111100000000000000000100000000000000000100000000000000000000001000000000000000000000000111111111111111111111111
11111111111111111111111100000000000000000011100011100010101000000000000000001000011100010000000000000000000111111111111111111111111
111111111111111111111111E0000000000000000000000100000010000010000000000000011100000000111000000000000C00000111111111111111111111111
11111111111111111111111111111111111111111111111111111111111111111111111111111111111111111111111111111100001111111111111111111111111
11111111111111111111111100000000000010000000000000000000000000000000000000000000000000000000000000000010000111111111111111111111111
11111111111111111111111100000000000011111111111111111111111111111110000000000000000000000000000000000000000111111111111111111111111
111111111111111111111111000000000000000000000000000000000000000000C0000000000000000000000000000000000000100111111111111111111111111
11111111111111111111111100000000000011111111111111111111111111111110000000000000000000000000000000000000101111111111111111111111111
11111111111111111111111100C00000000010000000000000000000000000000000000000000000000000000000000000000000000111111111111111111111111
11111111111111111111111100011111111111111111111111111111111111111111111111111010101111111111111111111110110111111111111111111111111
11111111111111111111111110000000000000000000000000000000000000000000110000000000000001110000000000000000000111111111111111111111111
111111111111111111111111010000000000000000000000100010000000000000001100000000000000001C0000000000000001000111111111111111111111111
111111111111111111111111001C0000000000000000001000100010000000000P00110000000000001000111000000000000000100011111111111111111111111
11111111111111111111111111111111111111111111111111111111111111111111111111111111111111111111111111111111111111111111111111111111111
11111111111111111111111111111111111111111111111111111111111111111111111111111111111111111111111111111111111111111111111111111111111
11111111111111111111111111111111111111111111111111111111111111111111111111111111111111111111111111111111111111111111111111111111111
11111111111111111111111111111111111111111111111111111111111111111111111111111111111111111111111111111111111111111111111111111111111
11111111111111111111111111111111111111111111111111111111111111111111111111111111111111111111111111111111111111111111111111111111111
11111111111111111111111111111111111111111111111111111111111111111111111111111111111111111111111111111111111111111111111111111111111
