11111111111111111111111111111111111111111111111111111111111111111111111111111111111111111111111111
1000000000000000000000000000000000000000000000000000000000000000000000000000000000000000E000000001
100000000000000000000000000000000000000000000000000000000000000000000000000000000000000C1000000001
10000000000000000000000000000000000000000000000000000000000000000000000000000000000000C10100000001
1000000000000000000000000000000000000000000000000000000000000000000000000000000000000C100010000001
10000000000000000000000000000000000000000000000000000000000000000000000000000000010001000001000001
10000000000000000000000000000000000000000000000000000000000000000000000000001110011111111111111111
10000000000000000000000000000000000000000000000000000000000000000000000000100000010000000000000001
1C00000010000000000000000000000000000000000000000000C00C00C00C00C000000011100000010000000000000001
1111000111000010000C000000C00000000000000000000000000000000000000000000100000000011111111111111111
1000000010000C100001110000111100000010000000001110001001001001001001111100000000010000000000000001
100000000000C1110000000000000000000011000000011000000000000000000000000000000000010000000000000001
1P000000000011111000000000000000000001100C00110000000000000000000000000000000000011111111111111111
11111111111111111111111111111111111111111111111111111111111111111111111111111111111111111111111111
