111111111111111111111111111111111111111111111111111111111111111111111111111111111111111111111111111111111
100000000000000000000000000000000000000000000000000000000000000000000000000000000000000000000000000000001
10000000000000000000000000000000000000000000000000000000000000000000C00000C000000000000000000000000010001
100000000000000000000000000000000000000C00111111111111111111111111111000111000000000000000000000000100001
100000000000000000000000000000000000000100000000000000000000000000000000000001000000000000000000001000001
100000C00000000000001000000000000000010100000000000000000000000000000000000000100000000000000000010000001
1000000000000000000010000000000000C0000100000000000000000000000000000000000000010000000000000000100000001
1P000000000C0000000C10000000010000100001000000000000000000000000000000000000000010000000000000010000000E1
111111111111111111111111111111111111111111111111111111111111111111111111111111111111111111111111111111111
