1111111111111111111111111111111111111111111111111111111111111111
1000000000111000000100000010000000010101000000000111111111111111
1P00000000111000000010000100000000001110000000000111111111111111
1111000000111000000001111000000000000100000000000111111111111111
1000001100111000000000000000000000000000000000000111111111111111
1011000000111000010000000000010000000000000000000111111111111111
1000001100111000111000000000111000000000000000000000000000000001
1011000000111000010000000000010000000100000000000000000000000001
1000001100000000000000000000000000001110000000000000000000000001
1000000000000000000000000000000000010101000000000000000000000CE1
1111111111111111111111111111111111111111111111111111111111111111
