111111111111111111111111111111111111111111111111111111111111111111111111111111111
100C00000000000000000000000000000000000000000000000000011111111111111111111111111
111100000000000000000000000000000000000000000000000000011111111111111111111111111
1001111C0000000000000000000000000000000000000000000000011111111111111111111111111
100100011000000000000000000000000000000000000000000000011111111111111111111111111
100100010100000000000000000000000000000000000000000000011111111111111111111111111
10010001000011C000000000000000000000000000000000000000011111111111111111111111111
100100010001001100000000000000000000000000000000000000011111111111111111111111111
100100010000001000000000000000000000000000000000000000011111111111111111111111111
100100010000001000000000000000000000000000000000000000001111111111111111111111111
101111111111111111111111111111111111000000000000000000001111111111111111111111111
101000000000000000000000000000000000001111111111111111001111111111111111111111111
101C00000000000000000000000000000000000010000000000000001111111111111111111111111
1011110011111111111111101111111111111100111111111111111C1111111111111111111111111
1000000011111111111111100000000000000001111111111111111C1111111111111111111111111
1000001111111111111111100001001000000011111111111111111C1111111111111111111111111
1P00011111111111111111100000000000000111111111111111111C1111111111111111111111111
1111111111111111111111100011111100001111111111111111111C1111111111111111111111111
1111111111111111111111100010000100011111111111111111111C1111111111111111111111111
1111111111111111111111111111111111111111111111111111111C1111111111111111111111111
1111111111111111111111111111111111111111111111111111111C1111111111111111111111111
1111111111111111111111111111111111111111111111111111111C1111111111111111111111111
1111111111111111111111111111111111111111111111111111111C1111111111111111111111111
1111111111111111111111111111111111111111111111111111111C1111111111111111111111111
1111111111111111111111111111111111111111111111111111111C1111111111111111111111111
1111111111111111111111111111111111111111111111111111111C1111111111111111111111111
1111111111111111111111111111111111111111111111111111111C1111111111111111111111111
1111111111111111111111111111111111111111111111111111111C1111111111111111111111111
1111111111111111111111111111111111111111111111111111111C1111111111111111111111111
1111111111111111111111111111111111111111111111111111111C1111111111111111111111111
1111111111111111111111111111111111111111111111111111111C1111111111111111111111111
1111111111111111111111111111111111111111111111111111111C1111111111111111111111111
1111111111111111111111111111111111111111111111111111111C1111111111111111111111111
1111111111111111111111111111111111111111111111111111111C1111111111111111111111111
1111111111111111111111111111111111111111111111111111111C1111111111111111111111111
1111111111111111111111111111111111111111111111111111111C1111111111111111111111111
1111111111111111111111111111111111111111111111111111111C1111111111111111111111111
1111111111111111111111111111111111111111111111111111111C1111111111111111111111111
1111111111111111111111111111111111111111111111111111111C1111111111111111111111111
1111111111111111111111111111111111111111111111111111111C1111111111111111111111111
1111111111111111111111111111111111111111111111111111111C1111111111111111111111111
1111111111111111111111111111111111111111111111111111111C1111111111111111111111111
1111111111111111111111111111111111111111111111111111111C1111111111111111111111111
1111111111111111111111111111111111111111111111111111111C1111111111111111111111111
1111111111111111111111111111111111111111111111111111111C1111111111111111111111111
1111111111111111111111111111111111111111111111111111111C1111111111111111111111111
1111111111111111111111111111111111111111111111111111111C1111111111111111111111111
1111111111111111111111111111111111111111111111111111111C1111111111111111111111111
1111111111111111111111111111111111111111111111111111111C1111111111111111111111111
1111111111111111111111111111111111111111111111111111111C1111111111111111111111111
1111111111111111111111111111111111111111111111111111111C1111111111111111111111111
1111111111111111111111111111111111111111111111111111111C1111111111111111111111111
1111111111111111111111111111111111111111111111111111111C1111111111111111111111111
1111111111111111111111111111111111111111111110111111111C1111111111111111111111111
1111111111111111111111111111111111111111111111111011111E1111111111111111111111111
111111111111111111111111111111111111111111111111111111111111111111111111111111111
