11111111111111111111
1E100000000000000001
11000000000000000001
10000000000000000001
10000000000000000001
1000000P0000000000C1
11111111111111111111
