11111111111111111111
10000000000000000001
10000000000000000001
10000000000000000001
11000000000000000011
100C000P0000000001E1
11111111111111111111
